belt guide position	pos
position	neg
front passenger safety belt	pos
window shelf	neg
child restraint	neg
isofix	neg
suitable child restraint fixing system	neg
fixing point	pos
unexpected movement	neg
front, knee and side airbags	pos
mounts	pos
front passenger airbags	pos
rear safety belts	pos
page	neg
indicated covers	neg
head restraint	pos
backrests	pos
lower anchors	neg
front	neg
user's manual	pos
various functions	neg
event	neg
deactivated front passenger airbags	neg
backrest width	pos
passenger side	neg
mounting eyes	pos
windows	pos
lower latch anchorss	pos
lower	neg
rear	neg
gap	neg
systems	neg
doors	pos
safety belts	pos
safety belt	pos
lower latch anchors	pos
child	neg
level	neg
operating and safety information	pos
effect	neg
hook	pos
retaining strap	pos
safety switch	pos
degree	neg
6.. lower and lock head restraints	neg
button	pos
belt guide	neg
height	neg
deactivate the front passenger airbags	neg
upper fixing point	pos
functions	neg
angle	neg
sharp edges	neg
than 5 ft/150 cm	neg
weight	neg
tether	pos
crs weight	neg
front passenger side	neg
deactivating airbags	neg
manufacturer's information	neg
place	neg
point/eye	neg
safety	neg
movement	neg
rear doors	pos
rear safety belt	pos
information	neg
harness	pos
door	pos
airbags	pos
accident	pos
latch child restraint fixing system	pos
protection	neg
rear: safety switch	neg
vehicle seat	pos
latch child restraint fixing systems	pos
system	neg
adjustable backrest	neg
supports	neg
back seat	pos
taut	neg
crs	pos
vehicle equipment	pos
safest place	neg
accordance	neg
direction	neg
highest position	neg
belt	pos
mounting points	pos
lower anchors and tether for children	pos
knee	neg
lever	neg
edges	neg
stability	neg
head restraints	pos
rear seat backrest	pos
outside	neg
side airbags	pos
adjustment	neg
travel head restraint	pos
optimal protection	neg
latch	pos
internal harness	pos
child seat security	pos
belt webbing	pos
passenger safety belt	pos
follow manufacturer's information	neg
passenger seat	pos
point cover	neg
anchors	neg
protective effect	neg
headrest	pos
memory position	neg
upper mounting point	pos
risk	neg
tether strap	pos
mounting point/eye	pos
children	neg
size	neg
65 lb/30 kg	neg
point	neg
accident research	neg
child restraint fixing system	pos
seat backrest	pos
internal harnesses	pos
increased risk	neg
hints	neg
retaining	neg
harnesses	pos
best possible belt guide position	neg
way	neg
mounting point cover	pos
headrest height	pos
right place	neg
seat	pos
unbuckle	neg
travel	neg
passenger airbags	pos
eyes	neg
rear seat backrests	pos
child restraint fixing systems	pos
driver's door	neg
injury	neg
mounting child restraint	neg
backrest	pos
front passenger seat	pos
13 years	neg
width	neg
manual	pos
latch anchors	pos
best possible position	neg
belt buckle	pos
mounting point	pos
child seat	pos
rear window shelf	pos
through-loading system	pos
upper retaining strap	pos
age	neg
strap guide	pos
locking lever	pos
operating	neg
points	neg
strap	pos
two outer or three mounting points	neg
all backrests	neg
automatic deactivation	neg
system manufacturer	neg
eye	neg
covers	neg
combined child	neg
mounting eye	pos
